100 20
1 1 1 1 1 1 1 1 1 1 1 1 1 1 1 1 1 1 1 1 1 1 1 1 1 1 1 1 1 1 1 1 1 1 1 1 1 1 1 1 1 1 1 1 1 1 1 1 1 1 1 1 1 1 1 1 1 1 1 1 1 1 1 1 1 1 1 1 1 1 1 1 1 1 1 1 1 1 1 1 28 28 28 28 28 28 28 28 28 28 28 28 28 28 28 28 28 28 28 28
1 1 1 1 1 1 1 1 1 1 1 1 1 1 1 1 1 1 1 1 1 1 1 1 1 1 1 1 1 1 1 1 1 1 1 1 1 1 1 1 1 1 1 1 1 1 1 1 1 1 1 1 1 1 1 1 1 1 1 1 1 1 1 1 1 1 1 1 1 1 1 1 1 1 1 1 1 1 1 1 28 28 28 28 28 28 28 28 28 28 28 28 28 28 28 28 28 28 28 28
1 1 1 1 1 304 302 302 305 305 305 305 305 305 305 302 302 303 1 1 304 302 302 305 305 305 305 305 305 305 305 305 305 305 305 305 305 305 305 305 305 302 302 303 1 304 302 302 305 305 305 305 305 305 305 302 302 303 1 1 1 1 1 1 1 1 1 1 1 1 1 1 1 1 1 1 1 1 1 1 28 28 28 28 28 28 28 28 28 28 28 28 28 28 28 28 28 28 28 28
1 1 1 1 1 1 301 301 211 230 207 224 207 231 212 301 301 1 1 1 1 301 301 211 230 207 224 207 231 230 207 231 230 207 231 230 207 224 207 231 212 301 301 1 1 1 301 301 211 230 207 224 207 231 212 301 301 1 1 1 1 1 1 1 1 1 1 1 1 1 1 1 1 1 1 1 1 1 1 1 28 28 28 28 28 307 307 307 307 307 307 307 307 307 307 28 28 28 28 28
1 1 1 1 1 1 301 301 180 228 183 223 183 229 169 301 301 1 1 1 1 301 301 180 228 183 223 183 229 228 183 229 228 183 229 228 183 223 183 229 169 301 301 1 1 1 301 301 180 228 183 223 183 229 169 301 301 1 1 1 1 1 1 1 1 1 1 1 1 1 1 1 1 1 1 1 1 1 1 1 28 28 28 28 28 312 312 312 312 312 312 312 312 312 312 28 28 28 28 28
1 1 1 1 1 1 301 301 180 228 183 223 183 229 169 301 301 1 1 1 1 301 301 180 228 183 223 183 229 228 183 229 228 183 229 228 183 223 183 229 169 301 301 1 1 1 301 301 180 228 183 223 183 229 169 301 301 1 1 1 1 1 1 1 1 1 1 1 1 1 1 1 1 1 1 1 1 1 1 1 28 28 28 28 28 312 33 33 312 33 33 312 33 33 312 28 28 28 28 28
1 1 1 1 1 1 301 301 180 228 183 223 183 229 169 301 301 1 1 1 1 301 301 180 228 183 223 183 229 228 183 229 228 183 229 228 183 223 183 229 169 301 301 1 1 1 301 301 180 228 183 223 183 229 169 301 301 1 1 1 1 1 1 1 1 1 1 1 1 1 1 1 1 1 1 1 1 1 1 1 28 28 28 28 28 312 33 33 312 33 33 312 33 33 312 28 28 28 28 28
1 1 1 1 1 1 301 301 219 234 166 222 166 235 220 301 301 1 1 1 1 301 301 219 234 166 222 166 235 234 166 235 234 166 235 234 166 222 166 235 220 301 301 1 1 1 301 301 219 234 166 222 166 235 220 301 301 1 1 1 1 1 1 1 1 1 1 1 1 1 44 38 37 43 1 1 1 1 1 1 28 28 28 28 28 312 33 33 312 33 33 312 33 33 312 28 28 28 28 28
1 1 1 1 1 1 301 301 217 236 165 221 165 237 218 301 301 1 1 1 1 301 301 217 236 165 221 165 237 236 165 237 236 165 237 236 165 221 165 237 218 301 301 1 1 1 301 301 217 236 165 221 165 237 218 301 25 27 27 27 27 27 27 27 27 27 27 27 26 1 46 40 39 45 1 1 1 1 1 1 28 28 28 28 28 312 33 33 312 33 33 312 33 33 312 28 28 28 28 28
1 1 1 1 1 1 301 301 180 228 183 223 183 229 169 301 301 1 1 1 1 301 301 180 228 183 223 183 229 228 183 229 228 183 229 228 183 223 183 229 169 301 301 1 1 1 301 301 180 228 183 223 183 229 169 301 19 7 7 7 7 7 7 7 7 7 7 7 16 1 48 40 39 47 1 1 1 1 1 1 28 28 28 28 28 312 312 312 312 312 312 312 312 312 312 28 28 28 28 28
1 1 1 1 1 1 301 301 180 228 183 223 183 229 169 301 301 1 1 1 1 301 301 180 228 183 223 183 229 228 183 229 228 183 229 228 183 223 183 229 169 301 301 1 1 1 301 301 180 228 183 223 183 229 169 301 19 7 7 7 7 7 7 7 7 7 7 7 16 1 1 56 55 1 1 1 1 1 1 1 28 28 28 28 28 312 33 33 312 33 33 312 33 311 76 28 28 28 28 28
1 1 1 1 1 1 301 301 180 228 183 223 183 229 169 301 301 1 1 1 1 301 301 180 228 183 223 183 229 228 183 229 228 183 229 228 183 223 183 229 169 301 301 1 1 1 301 301 180 228 183 223 183 229 169 301 19 7 7 7 7 7 7 7 7 7 7 7 16 1 1 57 55 1 1 1 1 1 1 1 28 28 28 28 28 312 33 33 312 33 33 312 308 7 309 28 28 28 28 28
1 1 1 1 1 1 300 300 213 232 53 58 208 233 214 300 300 1 1 1 5 18 18 18 18 18 18 24 5 18 18 18 18 18 18 24 5 18 18 18 18 18 18 24 1 1 300 300 213 232 208 225 208 233 214 300 19 7 7 7 7 7 7 7 7 7 7 7 16 1 1 54 55 1 1 1 1 1 1 1 28 28 28 28 28 312 33 33 312 33 33 312 33 310 76 28 28 28 28 28
1 1 1 1 1 1 104 105 106 107 63 64 113 113 113 113 113 1 1 1 13 10 10 10 10 10 10 23 13 10 10 10 10 10 10 23 13 10 10 10 10 10 10 23 1 1 1 1 1 1 1 1 1 1 1 1 19 7 7 7 7 7 7 7 7 7 7 7 16 1 1 54 55 1 1 1 1 1 1 1 28 28 28 28 28 312 312 312 312 312 312 312 312 312 312 28 28 28 28 28
1 1 1 1 1 1 114 115 116 117 118 119 120 121 122 123 124 1 1 15 65 17 17 17 17 17 17 22 65 17 17 17 17 17 17 22 65 17 17 17 17 17 17 22 15 1 1 70 90 91 1 1 1 1 1 1 31 20 20 20 20 20 20 20 20 20 20 20 32 1 1 54 55 1 1 1 1 1 1 1 28 28 28 28 28 312 33 33 312 33 33 312 33 33 312 28 28 28 28 28
1 1 1 1 1 1 125 126 127 128 129 126 154 155 159 159 186 1 1 15 11 299 299 299 299 299 299 12 11 299 299 299 299 299 299 12 11 299 299 299 299 299 299 12 15 1 1 75 76 93 1 1 1 1 1 275 276 276 276 277 275 276 276 276 277 275 276 276 276 277 1 54 55 1 1 1 1 1 1 1 28 28 28 28 28 312 33 33 312 33 33 312 33 33 312 28 28 28 28 28
1 1 1 1 1 1 136 137 137 132 133 131 146 134 130 130 132 1 1 15 15 15 15 15 15 15 15 15 15 15 15 15 15 15 15 15 15 15 15 15 15 15 15 15 15 1 1 80 94 95 1 1 1 1 1 279 280 280 280 278 279 280 280 280 278 279 280 280 280 278 1 54 55 1 1 1 1 1 1 1 28 28 28 28 28 312 33 33 312 33 33 312 33 33 312 28 28 28 28 28
1 1 1 1 1 1 134 130 130 132 144 130 151 134 130 130 132 1 1 15 15 15 15 15 15 15 15 15 15 15 15 15 15 15 15 15 15 15 15 15 15 15 15 15 15 1 1 85 76 97 1 1 1 1 1 290 291 291 291 289 290 291 291 291 289 290 291 291 291 289 1 54 55 1 1 1 1 1 1 1 28 28 28 28 28 312 33 33 312 33 33 312 33 33 312 28 28 28 28 28
2 2 2 2 2 2 158 162 162 143 147 147 147 140 142 142 143 2 2 14 297 297 297 297 297 297 297 67 68 297 297 297 297 297 297 297 297 297 297 297 297 297 297 297 14 2 2 101 102 103 2 2 2 2 2 286 287 287 287 288 286 287 287 287 288 286 287 287 287 288 2 51 52 2 2 2 2 2 2 2 29 29 29 29 29 306 306 306 306 306 306 306 306 306 306 29 29 29 29 29
0 0 0 0 0 0 0 0 0 0 0 0 0 0 0 0 0 0 0 0 0 0 0 0 0 0 0 72 73 0 0 0 0 0 0 0 0 0 0 0 0 0 0 0 0 0 0 0 0 0 0 0 0 0 0 0 0 0 0 0 0 0 0 0 0 0 0 0 0 0 0 0 0 0 0 0 0 0 0 0 0 0 0 0 0 0 0 0 0 0 0 0 0 0 0 0 0 0 0 0